S$$$$$$1 - CURRENT MEMBER                                                 N O D E
S        - SMF DATA REPORT
$$$$$$   - AAMMDD REPORT DATE
D        - DAILY
REPORT FIELDS DESCRIPTION:
 JOBNAME         - JOB NAME
 JOBNUMB         - JOB NUMBER
 SYSTEM          - SYSTEM ID
 USERID          - RACF USERID
 STN             - STEP NUMBER
 PG              - PERFORMANCE GROUP
 SDATE           - STARTIDATE (HH:MM:SS)
 EDATE           - ENDADATE   (HH:MM:SS)
 STIME           - STARTITIME (HH:MM:SS)
 ETIME           - ENDATIME   (HH:MM:SS)
 DTIME           - DURATION   (HH:MM:SS)
 PROGRAMMER NAME - PROGRAMMER NAME AS SMF 30 RECORD
 CLASS           - EXECUTION CLASS
 CPU SRV         - CPU SERVICES UNIT
 SRB SRV         - SRB SERVICES UNIT
 I/O SRV         - I/O SERVICES UNIT
 MSO SRV         - MSO SERCICES UNIT
 DP              - DISPATCHING PRIORITY
 CPU TIME        - CPU UTILIZATION (HH:MM:SS)
 CPU SRB TIME    - SRB CPU UTILIZATION SRB (HH:MM:SS)
 CPU TCB TIME    - TCB CPU UTILIZATION TCP (HH:MM:SS)
 JOB TIME        - JOB UTILIZATION TIME (HH:MM:SS)
 INIT TIME       - INITIATOR UTILIZATION (INIT) (HH:MM:SS)
 TAPE MOUNTS     - NUMBER OF TAPES MOUNTS
 RC              - RETURN CODE
 MIPS            - ESTIMATED MIPS UTILIZATION BY JOB
 ZIIP TME        - ESTIMATED TIME AT ZIIP PROCESSOR
