
             INDEX to MEMBERS in the TSSO.VERS43.ASM dataset



$ENDOFDA -->  SAMPLE IEFBR14 JOB: AOF CAN TRAP THE END OF JOB MESSAGE
$PAYROLL -->  DITTO
AGCOASM  -->  PROC to ASSEMBLE most TSSO subsystem modules
ALOCCACH -->  SAMPLE CLIST TO ALLOCATE FILES NEEDED TO RUN THE CACHE
              COMMAND FROM A TSO USERID
ALTAOF   -->  ALTAOF command:  Change MLIM dynamically for tsso/aof
AOFIVP   -->  Sample AOF table - shows all forms of TABENTRY macro
AOFSEAG  -->  *SPRECHER AUTOMATION TABLE.29OCT92. USES MLWTO SUPPORT
ASMALL   -->  PROC to ASSEMBLE ALL TSSO processing modules
ASMONE   -->  PROC to ASSEMBLE ONE processing module
ASMTABLE -->  PROC to ASSEMBLE an AOF table
ASMTSSO  -->  PROC to ASSEMBLE all TSSO subsystem modules - needed if
              the TSSOCVT or TSSODATD macros are altered
CACHE    -->  CACHE command: Controls a 3880 CACHE control unit
COPYPROC -->  PROC to copy the sample TSSO START PROC into SYS1.PROCLIB
CPCMD    -->  CPCMD command: Issue a CP command if running under VM
DATAAREA -->  A non-comprehensive list of the major tsso data areas...
DISPAOF  -->  DISPAOF command: Displays an active or inactive AOF table
EF       -->  EF command: Allows a file to be edited under TSSO
EQUATES  -->  Standard R0-R15 equate macro
EXASK    -->  EXAMPLE CLIST using the OSASK command
EXCHKSPL -->  EXAMPLE CLIST using OSCMD command with manipulate of
              the response
EXJOBS   -->  Another EXAMPLE using OSCMD
EXSTVTAM -->  An example of OSCMD without response retrievel
FORMAT   -->  Macro to format numbers from assembler programs
GENTAPE  -->  PROC to generate the TSSO distribution tape
GETCVT   -->  MACRO to find the TSSO CVT (SSCTSUSE field in TSSO SSCT)
ISXA     -->  MACRO to determine if running under MVS/XA
JCECVT   -->  Subroutine to do decimal/hex conversions
LINKLIST -->  LINKLIST command: Displays MVS LNKLST concatentation
LIONRPLY -->  Csect to extract buffers from Console A/S for REPLYLOA
MENTER   -->  MACRO for beginning subroutine linkage
MLEAVE   -->  MACRO for closing subgroutine linkage
MPFLSTSE -->  *SPRECHER MPF LIST FROM SYS1.PARMLIB - VERY AGGRESSIVE
MULT     -->  Bill Godfrey's MULT command: Enter multiple commands on
              a line - great for commands that have subcommands
NCFOSATH -->  The NCCF user authorization exit.
NCFOSCMD -->  The NCCF version of the OSCMD command processor.
OPCMDMSG -->  A message CSECT for callers of TSSOPCMD.
OSASK    -->  OSASK command: Ask the operator a question.

OSCMD    -->  OSCMD command: Issue MVS command and get response

OSCMDATH -->  The user exit for the OSCMD TSO facility.
OSCMDICB -->  OSCMD Interface Control Block - for communication
              between TSSOPCMD and TSSOSS09
OSPAUSE  -->  OSPAUSE command: Delay a CLIST
OSWAIT   -->  The OSWAIT command processor.
OSWAITRC -->  The recovery and cleanup routine for oswait.
OSWTO    -->  OSWTO command: Issue message to the operator
PTFS     -->  A summary of the PTFS to TSSO 4.2 that are in 4.3.
RELGDE41 -->  TSSO 4.1 release guide
RELGDE42 -->  TSSO 4.2 release guide
RELGDE43 -->  TSSO 4.3 release guide
REPLY    -->  REPLY command: Issue a REPLY command by message id
REPLYLOA -->  REPLYLOA module: check outstanding replies
REPLYLOB -->  REPLYLOA from Guy Albertelli.
RUNASM   -->  RUNASM PROC for assembling TSSO modules.
SAMPPARM -->  SAMPLE parameters for SYS1.PARMLIB(TSSOPARM)
SEAGUGIP -->  *UOW SCRIPT OF TSSO USER MANUAL FOR SEAG MODS
SEAGUGOP -->  *DOCUMENTATION ON SPRECHER MODS TO TSSO FOR MLWTO
SETMODE  -->  SETMODE MACRO for changing mode (24 bit - 31 bit)
SETPARSE -->  SETPARSE MACRO for setting up IKJPARS control blocks
SPMON    -->  SPMON command for performance monitoring
SSCONCB  -->  Subsystem Control Control Block DSECT.
SSCOBCBH -->  DSECT for the SSCONCB header.
SSID     -->  SSID macro for obtaining SMF system id
TABEND   -->  TABEND macro for defining END of AOF table
TABENTRY -->  TABENTRY macro for defining AOF table entries
TABSTART -->  TABSTART macro for defining START of AOF entry
TLINE    -->  TLINE MACRO for doing TPUT of character string
TSSLRACF -->  TSSLRACF subroutine for doing RACINITS in #.LOGON cmd
TSSO     -->  TSSO mainline initialization handler.
TSSOCCMD -->  TSSOCCMD subroutine for handling TSSO control commands
TSSOCMND -->  TSSOCMND macro for defining control block to interface
              between TSSO and TSSOSS10 (CMDRING DSECT)
TSSOCVT  -->  Mapping MACRO for TSSO's CVT
TSSODATD -->  Mapping MACRO for TSSO's private data area
TSSODOCM -->  TSSODOCM subroutine for handling TSO commands under TSSO
TSSOESTA -->  TSSOESTA subroutine for handling TSSO errors
TSSOGAPF -->  TSSO cross memory services routine to get APF authorizied.
TSSOGSSC -->  TSSOGSSC for interface for subsystem allocatable consoles
TSSOINIT -->  TSSO routine for IPL time initialization.
TSSOINI1 -->  TSSOINI1: TSSO initialization- part 1 (init datd)
TSSOINI2 -->  TSSOINI2: TSSO initialization- part 2 (process parmlib)
TSSOINI3 -->  TSSOINI3: TSSO initialization- part 3 (default security)
TSSOINI4 -->  TSSOINI4: TSSO initialization- part 4 (ss consoles)
TSSOINI5 -->  TSSOINI5: TSSO initialization- part 5 (xmem services)
TSSOMAIN -->  TSSO mainline routine for processing TSO commands
TSSONDSA -->  TSSO NON DISRUPTABLE SYSTEM AREA DSECT.
TSSOPARS -->  TSSOPARS subroutine for parsing just about anything
TSSOPCMD -->  Routine to process operating system cmds and return
              The responses to a buffer.
TSSOPREC -->  Recovery routine for TSSOPCMD.
TSSOPROC -->  A sample proc for use in starting TSSO (S TSSO)
TSSOSECR -->  TSSOSECR mapping macro to map the TSSO security control
              block

TSSOSS09 -->  TSSO WTO intercept routine (subsys code 9)

TSSOSS10 -->  TSSO Command intercept routine (subsys code 10)

TSSOTERM -->  TSSOTERM module for handling TSSO termination
TSSOWTO  -->  TSSOWTO module for copying SYSTSPRT file to console after
              commands
UNDERTSO -->  UNDERTSO MACRO to determine if your running under TSO
USEGDESC -->  The TSSO Users Guide - complete with SCRIPT control
              words
USEGDE41 -->  The Users Guide for TSSO 4.1
USEGDE42 -->  The Users Guide for TSSO 4.2
UG43TERM -->  The Users Guide for TSSO 4.3 (Current Version)
VALLOC   -->  VALLOC command for displaying MVS allocation information
VOLSER   -->  VOLSER command for displaying MVS UCB information

XSSOSS09 -->  Old version of TSSO WTO intercept routine (subsys code 9)

Items in member CLISTS from SPRECHER ENERGIE AG

CLISTS / HSMCYCLE*CLIST STOPS AND RESTARTS DF/HSM.....................*/
CLISTS / HSMSTOP *CLIST STOPS DF/HSM AND WAITS FOR THE JES2 ENDED MSG.*/
CLISTS / HSMTAPE *CLIST CHECKS AVAILABILITY OF TAPES FOR DF/HSM.......*/
CLISTS / NOPAPER *CLIST DISABLES JES328X PRINTERS WITH INTVN REQUIRED */
CLISTS / PRIME   *CLIST TO TEST FOR PRIME SHIFT. RETURN RC(0) IF YES. */
CLISTS / RESTART *RESTART A JES328X PRINTER STOPPED BY NOPAPER....... */
CLISTS / RMTGO   *AUTOMATICALLY START RMT PRINTER ON FORM CHANGE..... */

Items in member CLISTS from AGCO UK Ltd.

CLISTS / DOWN    *Generalised shutdown routine........................*/
CLISTS / ONLYTSO *Example of a shutdown clist, uses DOWN and SURE.....*/
CLISTS / SURE    *Get Operator confirmation...........................*/
